20
15
+-+-+----+---------+
| +-+              |
|L     + +-------+ |
+------+ |       | |
|      | |  +-++ | |
| +-+  | |     | | |
| | |  + +--+  | | |
| | |    |  |  | | |
| +-+----+--+  | | |
| |         |  | +-+
| +-------+ +  |   |
|              |   |
+-+ +----------+ +-+
| |            | | |
+-+------------+P+-+